shanaas : meritoriousness
dquinnell : gowfs
patinoj : lawniest
lyonss : telephonists
butlere2 : parslied
poeschlaa : eradicated
fleishhackerj : bedrolls
griffina2 : clemmed
schallyn : premoisten
hplip : undressing
qianp2 : verier
gebreegziabhery : dratting
thandis2 : roystered
culverwellr : movable
jlarson : mintiest
clarka2 : nosographies
coganp2 : booziest
shannoh : rifleman
ironsw : scrummagers
jurkovichm : sudamen
sewellk : zingel
pakl : amblings
grauers : redisbursing
grossmanj2 : filo
jpierret : bigwigs
kroppa : potashed
haddady : requote
szetob2 : typhogenic
tiltonm : onychophorans
ahmedk2 : loafed
pihlajaa : plurry
xiongk2 : mirthfulnesses
dema : subdominants
davisk2 : unreprimanded
gordong : disavows
jinga : purlers
orepoorjays : preinterview
lkolek : futurities
wilsond3 : coholders
horia : dais
ntop : luteolin
klanderudj : dipolar
johnsont4 : helios
hozm : misphrase
slovesb : sforzandi
hills : phylarch
choa : stewpond
knopk : gastrosopher
meyerb : chawdrons
burtonk : towaway
rabagoa : balsams
yangm3 : photographed
poreddyn : buckshish
solakhavam : blueball
geoclue : saginating
yoshidah : nonbelligerent
chiut : soundtrack
ricos : ragging
franchotl : confessing
brewsterw : desegregations
nechiporukm : diaskeuast
wanga3 : stationmaster
thompsond3 : solvations
rbarkmei : overdares
windleyb : jaspilite
rdobrow : hempweeds
gormane2 : radioscopic
tisserandm : multiplicate
longe : falsefaces
fickl : demotic
rhodess2 : ambary
hofmannm : aeration
fongj : strophic
ogradyf : lawless
davish : torcher
hlavacekz : rumlegumptions
goldbergm2 : bullered
scotti2 : lanceolar
veeam-mathcs : windbill
fanp : recreancy
stahla : germanenesses
nachreinerl : rowlocks
jablem : drivings
banksa : hypoglossal
gallina3 : dampens
_apt : endogamy
hannigank : reverberatories
mukeshimanag : untenderly
tianh : florider
dianas : slenters
zhanga3 : stushie
swansonm2 : coombes
dgroll : stonecuttings
wardk2 : overhopes
pearsonc : autocatalyze
morrisseya : jobberies
hazeng : jowlier
aroras2 : seamaid
nakahiraa : dramatisable
sleonhar : offshorings
halle2 : nictations
dehaans : enplanes
taboram : odographs
lehmane : adorabilities
legbaf : embryogenesis
fernandezm : nirling
strubeliramm : mathematicised
smitherbm : discriminants
tmyint : unbooting
smithk4 : weanels
lordk : stargazings
mortenseni : chorial
franzene : vading
cups-pk-helper : coastal
fernandesj : obverses
nguyenn2 : obverses
claussm : episcopizing
heywoodl : propellers
penprasea : prolixities
greifft : henceforward
murphym2 : coryzal
williamsn2 : oestrums
destab : gouty
rogerse2 : zoophilias
zappam : regionalist
gaoa : eversible
hultmanl : heh
suns : capacitated
ricea2 : measling
rojasr : bancs
hadoopuser : blase
mirandal : ugsome
brownl3 : antisatellite
kramerj2 : harpooning
grossere : freighters
antrims : duumvirs
lelea2 : consubsisting
dfoxgrov : hagdens
ibtesumm : agog
ruanc : remythologises
minj : valleyed
aexley : canzone
liuy2 : shields
konshiel : bombesin
sainiv : develing
wolfl : calmodulin
huangc2 : gossiping
kitchenc : herlings
zhangz2 : falls
pageb2 : neovitalist
kaitanym : ubiquitous
ulicnys : aperiodically
friedmant : loanback
mccayi : amoles
hackenmuellerh : reorders
rosethc : niches
hensonm : cynical
woodruffe : lychee
lp : conjunction
weinerk : surimi
bradies : mathematises
jolson : unreprovable
davisa4 : batswing
winstonl2 : bulbil
mckelveyb : sixteenmos
jajodiaa : isocheimenals
flowersr : periclitate
shiny : bombax
zhuh : significant
bells2 : typographically
tidrickd : lottery
lopezn : rigider
rhea : shoe
quanbecks : miffinesses
kongd : utterest
kima3 : allogenic
holmesc2 : astrosphere
romans2 : ponding
sternh2 : refrigerative
viswanathana : pliancy
duh2 : prebuy
berryn : intromissions
dunnj2 : soyles
duncandog : holophyte
kerwinm : reservationists
yime2 : greenback
whitfielda : chirimoyas
its : bosonic
mcgovernd : whooper
mdecker : consonancies
lanierk : mockney
klinem2 : gorgio
marlinj : tathed
reyesrojasc : inspectors
systemd-coredump : tipster
zimmermane : nuttier
caok : lichening
grossea2 : towbars
cramptonc : periselenium
fcontreras : paintiest
lil4 : analeptic
haasl : detersives
wcislol : fibrousnesses
hliuspen : inspection
witneyj : epicists
pakulad : plusage
paulyg : panislamic
uuidd : proyns
mccreap2 : waurs
kingn2 : syphons
loxe : syphons
cunninghamf : readdicting
ogolaj : fripons
surdutovicho : untrammeled
farnsworthh : obstructer
cohenl2 : piper
stovallm : vapidest
thornea : biliaries
sharmas : cartelist
xue : superpositions
colburng : heaver
shutez : counsellable
zhue : duckbills
rousseauh : jejunities
piusa : scaling
mohameds : pilling
kellyc2 : mersion
rthompson : pernancy
ellisn : cardamoms
wilsong2 : clerihew
weges : cypselae
dujsikovaa : cokuloris
chuc : antileptons
news : rehearsing
guw : opt
cuttera : iatrochemist
knights3 : corporealizing
lir3 : askaris
sunn2 : eely
smithi : caramelise
moutsatsosd : cleruchia
godinezk : dateable
schillj : blacktails
srinivasans : anomy
steinr2 : secretion
backup : susceptibility
wangs7 : epoxy
taa : toiseachs
ulrichk : spurred
freedmanm : reincreasing
zweifelc : hobnobbed
nachtm2 : riderships
carranzas : rearticulated
woodruffn : daffings
saned : haddies
apchikka : heedfully
yuh : withdrawments
bassekleg : altos
marksa : reinsurers
pateli : tautomer
detmero : wakes
mirzaw : bistort
samadanic : extraordinaries
figueroav : gramoche
brownm3 : missuited
cichowskil : legators
speech-dispatcher : overquick
rkeiser : kalpac
barhama : ceorlish
bradjanv : postdepression
tilleyr : explicably
dvergstenc : covenanting
wonacottr : substructions
salomonl : peristomatic
fbhuiyan : remissibility
wolffkinga : trekschuit
sarnos : sharpie
woollenb : runches
valtierrezf : shlemiels
yangb2 : festinating
mayad : risped
pandeyk : breakfront
wardh2 : joeys
hes2 : greaten
nguyenc : gulls
sigmondm : somniloquy
kindallv : xiphopagus
renz : proprietrices
jhallen : reuptakes
hanw : cookoffs
richardsonc : puissaunces
zhangy4 : jurymen
piccirilloj : psyches
mitchellk : bugbears
vipparlaa : underfeeds
rosenfeldm : dietetics
sheffieldf : shtetl
qina : dogmatic
jellinge : flagellin
hinrichsr : revellers
glaserz : insistencies
gomezpalmerm : toter
chend2 : faces
caia : smallboy
jahne : statically
williamsj3 : impostumes
muhlheimr : retirednesses
quinns : pirogue
deharpporteh : pantophobia
schulenberge : sprad
yambingj : sleaze
mangenat : recirculations
hollebp : venerations
chenge : sourcebooks
nakamotos : rhetorizes
sohailm : muktuks
glymphc : fishlines
walshw : varistors
fortsone : swamps
gaborm : hyperthymias
mallyas : pneumatolysis
daleyj : gopuras
ooiw : philologist
koroseie : refringed
petersonk : holophotal
bordenm2 : toothwashes
wrighte2 : plovery
stewarta2 : creolizing
lundbergh : exocytosing
vincentm : obligingnesses
laij : minorca
momseng : substantivising
madiganl : tenty
goetzs2 : glycerias
frankelh : carbines
richarte : phthisicky
shiffmanm : outgive
watsone3 : skeletonize
machaleck : jewelfishes
bakayokor : saggering
bisiol : projectments
villanuevaj : selfishly
hurtubisej : overswam
williamsn : corinthianising
eae : nodalised
asfawa : telefaxes
lburdell : behappened
nagpalj : appealable
garciareyesj : grufe
huh : geobotanies
sheridans : tuples
parkers2 : zebrines
shiferawh : entangles
weinsteinc : ragtimes
shapirob2 : gigglers
mckimh : megafarad
champlisst : murks
rapoports : bittiest
finew : andantino
gulatia : patriate
riverar : inexpectant
greenleee : senatorial
rossa2 : imminentness
rotix : scourie
rpetrick : religionizes
abelsonk : cnidarian
man : phlorizins
pollardc : phlorizins
demetriadesl : limaceous
geletar : interweaver
pareth : rappers
allene2 : pictorialises
huttlestonw : dispeace
gonzalezs : invoice
kushnern : beneficiation
nit : hospitalize
pliegoc : encapsulated
chenc : lilac
jschicker : accost
bacong : insufflation
lorenzf : redrawing
ortiza2 : simarouba
kelsoc : chavish
kronickc : stenciller
liw4 : scampered
oconnorm2 : shirtlifter
bestert : dichromatics
formano : milkshakes
isaacsonj : unchristens
abbasharm : metaphorically
spencere2 : musterers
loc : serenely
whitedavisj : surrendries
ckohnen : invades
martinezs : hikoiing
faruquis : aureola
wilsont2 : quadrivial
chene2 : nonelective
johnsons2 : pityriasis
loescherc : exscinding
richardsonb : tumpline
fraserminesk : timpanist
syoon : tantalising
blarocqu : flora
sloom : anastigmatism
arenasf : lowbrow
wanga4 : stodginess
bronstonea : monophonically
leee2 : reprehendable
weid : techniques
kimd : taxameters
wirthm : geophysicist
watta : cathected
drennana : sermoneers
walkerj2 : rations
kernoops : taths
sakimoto : myalls
wur2 : undernourishing
mahabira : unmeritedly
fitzhughn : withdrawn
nm-openvpn : flammules
onwumerea : vanishes
peerzadac : pinnacle
dejarlaisd : dastards
ramans : amylenes
kstrode : biogenesis
nehame : catchers
safdarh : jobcentres
systemd-network : bedropt
andersonb2 : frigid
ramann : prettification
westerr : amebiases
bernsteinb : wanky
schneiderb : copalms
wolffm : arms
yeec : amenability
warners2 : podophthalmous
lumbud : autocorrelation
owensj2 : tranche
mctaggartc : retallying
youngg2 : reconducting
muellerl2 : brooder
wangn4 : cockering
qiangt : tautly
freelandt : jaggheries
walshm3 : shockheaded
leej12 : technicalities
bowersj3 : pithless
chowdhuryt : crimeless
pharoz : tulipomanias
yel : cookware
lengx : rainmaker
mkruseme : microbiologists
emekar : justifiably
corletta : frogspawns
stohlerl : flatline
hoffmanj2 : torturing
cechinir : territoried
awadm : rhizocephalous
burberyc : unmilled
linj3 : cotrustees
crowni : somnambulant
aladetana : bootlicking
winstonx : douter
wilkinsonm2 : tuskings
x2goprint : unnethes
kingmal : messiahships
pohlmanr : unsightliest
floresc2 : bespreading
delnegron : rapping
gallantj : spume
duffyk : precedency
wintert2 : hellholes
hicksr : endomorphy
leitza : euclidean
bravop : linkster
chane : cutinizations
danielskoche : moliminous
uyekif : mezzo
reyese : reimages
tankersleyc : metalworkers
fischere3 : clarifications
collinsn : gastrulae
sandersc2 : satrap
smarta : meseems
linj4 : correspondency
schillingm : obsessionally
schumacherm : zabra
bartlettj : perruquiers
quaylep : rushlights
martensj : bantus
avahi-autoipd : effeminates
steelb : suspensorial
bells3 : unenlightened
basilef : aniseikonia
williamsj4 : hild
gerbinoa : sufflating
henryi : malacologist
hummeln : wageless
mooreb : furanose
lyuk : poorhouse
caldwellm : mistutor
minj2 : disaggregated
mendeza : destocking
rodriguezn : sycophancy
freemanc3 : fettuccines
carlsonj2 : slung
stanchfieldr : archerfish
brownr2 : toccatella
gassele : tsores
zhangx2 : winterkilling
statd : translocations
tyreek : wracks
tchouaffem : czarism
mckeevera : sudd
scheiderd : grege
jtymoczk : ankus
schmidtj3 : cepes
gevurtzs : woolgrower
flanaganj : jeeled
dennehys : ophthalmoscope
brandlc : tricepses
purduma : adjunctions
caplanb2 : unbedimmed
dyckj2 : biros
smithr4 : perpetuals
poolosz : handshakes
lil3 : fray
shirleyj : numismatists
trackmana : kat
tieut2 : steepier
schniedersb : hilarities
tellea : crosslights
satherz : howdah
gonzaleza : thrombotic
jacobsona : palsgravines
bicej : primogenial
aknodell : vegemite
banfieldb : toughish
wayl : scrumpled
khake : fluencies
crossh : chrominance
littone : sensitivities
hintons : powin
ursina : tenosynovitis
solomonh : kicker
dyermokg : liger
blackburnk : gadrooning
conroys : dandiacal
glovera : unideological
bboling : baronetcies
haddockc : inspectorial
olsonk2 : inspectorial
irakozef : transilluminate
kombatem : intimacy
givensn : bullshitter
sellersa : circumnavigate
romanovaa : stench
scotte2 : disappear
mcass : vowelizes
shafers : flexagons
sochackim : honorifics
reidt2 : fratery
panditk : umfazis
hansona : abioses
goldenberga : extinguishes
statsdata : genappe
peralesa : staniel
posnerc : pseudonym
escutiam : segments
tsuic : connoisseurs
lopezg2 : sherif
hultgrenk : whispers
przybylan : chivs
kaplang : twigger
zhoue3 : copromoter
yeha3 : isografting
mcmanuss : fallaciousness
keithahnh2 : jupon
randal : transducers
megar : remeeting
tasb : brutalises
hawkinsn2 : subnatural
mamantove : megasporic
morrisa4 : melicks
veraleyvas : unwork
gansc : treponematosis
guzmanm : andropauses
mohamedh2 : commute
jamesc3 : braks
wilmots2 : titmose
chenl3 : orgeats
frischm : persiflage
lij7 : transversion
enriquezd : spontaneities
dippoldc : eyeless
kulstadz : esquiring
rstudio-server : ionium
dhungels : hooroo
akeelh : epileptiform
rhyneers : freeholders
renb : pointes
curtisj2 : pinchguts
rivkinb : zooier
lanzilloj : trisoctahedrons
townsendl : functional
shumwaya : underexposures
szychera : radiciform
agboolar : buppy
sebestab : xenobiotic
zind : neeps
goldberge : intellectualise
rogersg2 : scanter
nagaokay : pother
eichelt : investigations
vangsteins : nandine
jeffersonk : rhesuses
cherians2 : novennial
sixs2 : underproduction
uedah2 : ave
mahmoods : poeticising
x2gouser : spatting
hettlea : drawbore
karln : cephalometer
watsone2 : orarion
gulledges : crankous
rourkee : reengineers
knutsonl2 : jauntiness
vazquezi : reinjure
schaefern : backswing
kandelj2 : malaprops
phamm : acknowledges
thurmana : woodskin
jensone2 : questionary
stieglerr : glossator
wardp : multicoated
bakerc2 : dissociation
mua : pademelons
newmanl : bellow
tannirae : diapausing
gangolfa : convents
mngodoh : cromornes
ritathompson : nomism
shawnz : splurged
cabanelak : snippetiest
zimmermant : tulchan
kleini : centralized
jondich : marmot
mcclaina : nutsedge
phillipsw2 : unlovingly
teetert : closest
kondas : nieces
lie2 : comraderies
deferm : mandataries
simonsi : outtalking
barfieldt : bimesters
hovingg : abscondences
garciad2 : superinfected
gunnarssonm : underkeepers
euaanantp : connumerations
shoped : atabrines
xuana : ulcerations
weldont2 : gollering
nyamaot : forager
shahe : nostocs
galec : dissolvability
fisherk2 : roundtrip
phungk : wald
chetitac : boatlifts
blairs : waymarked
iribes : nationhoods
longc2 : coextensively
chans : spruit
leeh3 : epidermis
corcoranj : unclean
knutsene : thuses
woodmancyl : histopathology
guerrerov : multiforms
hirshbergs : dogmatics
crumb : semirigid
elliottc2 : steeding
antwig : attestations
willsr : resentive
snarayan : shreiking
babcockc : interage
orlinz : kitesurfing
choderat : bemuddled
hayesrichn : misassigned
dnsmasq : zeins
szafrano : winching
forsterb : scientism
flodine : urethra
gudgelr : grasses
segalm : acetoxyls
kemptond : unroyally
jamesc2 : tripalmitin
hansong2 : centaurea
sscheirer : doodling
sierrao : skepticism
venetise : diplomatizes
sauerbergn : magnetospheric
gnats : turfite
enriqueza : pithiest
dkohen : sowffed
amdemariamr : strokers
crimmeln : demolisher
poulseni : trigamists
shenholma : whomping
plaschl : baudrics
krakaurd : hovels
hairstonk : kayoed
umbreite : reinspects
jonese4 : oophytic
hommeyerj : snicks
cfureslo : overstretching
rothmana : disputations
shreerom : birdbrain
alejandroe : saddling
basavareddir : balmorals
aroraa : unlimes
zacharskim : spirated
storke : autoptically
gangulya : guideway
dudarovw : daffies
vonga : nephograms
chisholma : demurred
yeomj : coenospecies
bowersj2 : liparites
taylorc2 : stenosed
tefub : hypocritical
hsun : pretensioning
vanders : airshow
linki : extasies
gilbertr2 : staplers
dgupta : valueless
penna : valueless
lic4 : unconformably
mothersheads : operationalists
johnsonl2 : froglings
karbowskim : aerophores
eiferta : jackman
watkinsd2 : infeudation
myerd : romanticises
axele : decolorated
zhaos3 : colloquizes
calabresep : furring
songj2 : yabby
hackerr : indorse
banovetzm : moussaka
singerg : kindergartner
shangj : tiebreaks
theisa : bashawism
redfernh : sticcatoes
rthompson2 : cliches
arnowb : antoninianuses
tinajeroa : endothelioma
mlupp : claptraps
leeg3 : affiliations
woodsj2 : occlusive
strathmana : waspie
bessore : smaragdine
pattersonc : preife
griers : august
chapleyd : lonenesses
chingl : beldam
hogansona : thioridazines
horiuchih : glomus
zhangx3 : topazine
dicarlos : agrafe
leuchtenbergerg : skaters
shoree : bloopers
lesliez : amorally
piperh : guimpes
woltersh : hasheesh
holcombh : toboggins
tss : rudderpost
xug : nonart
pattisona : coversines
gillenf : effuse
huffg : recuperation
obonon : sidebars
lehmanw : inhibitable
welchp : sometime
hedgecockn : bunias
shalitak : hoover
rgoerwit : hypercivilized
somaa : obstipations
chackerians : vivianites
hoppera2 : terebration
leonarda : placitory
valenciac : touchwoods
_rpc : troaks
yus2 : constituters
reynagag : flurring
beretsl : alkalescency
suy : nardine
preisserj : crisscrossed
xiee : nutwood
marvinc2 : custocks
anyiwee : unhedged
kucicha : oncogenic
kimbels : matches
bynumg : identically
clayo : panderers
costelloc : zoological
lipinskic : discoboli
merrells : obstreperated
hussemans : septenniums
lefkowitze : stat
cadaramc : envisagement
wyffelsm : sequencing
messagebus : pusser
gaoy2 : polychromatisms
chundrus : toxine
groganr : tomfoolery
dieschbourgm : eroticized
leegilligana : heckler
waltherp : becrowds
kongj : genouillere
mcdonnellp : winy
lanegraffe : pavings
choir2 : homestretches
diass : pompanos
ehrlichmanc : twanglers
mhansell : humidification
francoj : planimetric
curtise2 : broadcast
tany2 : ageneses
laceyi : duodecimal
zhengs : reconfiguring
kellerb2 : ayurvedas
weie : tantrisms
tydingsc : superiority
mathcsadmin : plunderers
dwalser : xenons
thomastothe : knarrier
vlahosstenn : mainlands
chungj2 : emotivenesses
shteymanm : nearing
proxy : adynamias
dominguezb : geomancers
okadak2 : lowned
bduffy : traditionality
ramirezj2 : inrushing
hiattl : peccancies
mcmillanr : crowstep
zhangyangj : offishnesses
jehngm : datelined
shererj : vivacities
buhmanq : cardiomyopathy
valem2 : zooplankters
moores3 : monteiths
zhaoh2 : proclises
jgoldfea : nettier
cfortin : ulnae
jimenezl : epidemically
brownc3 : clade
moranj2 : pennes
ngaik : tolzey
xiay : fanbase
sheltoni : deflectional
collinse : wawlings
carlsont3 : potful
kugell : anuria
lozoyaa : caprifigs
wangx2 : monastically
mcguckenk : iota
cardenasl : nona
kellyr2 : cheaped
reecel : perforations
tuchowj : cloudages
tumaa : afterburners
lees4 : taphonomies
nguyend : adventured
kjomek : nephralgy
escosteguyl : foxhunter
twichellh : restrung
yuez : lacelike
leduce : aphicides
gdm : metallically
whitej2 : flowcharts
lawlora : hypercomplex
changr : araeometry
blanchetteg : oosperms
viscontie : peeing
naganumaj : squired
tannenj : examplars
cruzc2 : repercussion
washingtonj : spoilages
misplonj : peewee
wigginsa : blither
konga : mentor
rolandc : advantage
sjandro : charquid
reyesf : espaliers
heymane : sombrous
bakerstahll : axed
smithm7 : overwatched
ramirezs : oons
frieds : craniopagi
owensm : eurekas
lieberkotzo : impede
schregardusc : submissnesses
folgeri : wacky
sg-admin : nonuniformity
schubertr : galvanisations
mukherjia2 : conductress
mittonfrya : bunches
wangy3 : buoyed
gelosf : stannators
kulkarnin : minimise
morrisn : retrogressional
tfreudenberg : intercalary
mackinj2 : supertitle
smithj6 : raiseable
hintonp : puerperal
eppersonc : venatical
woleskyp : plasticize
youngr2 : fossicks
prevesc : decorations
shent : orthopteroid
amontero : heckelphone
swansonl2 : villadoms
farrl : hipper
santosr : wayfare
riveraf : importunacy
clawsoni : martialnesses
nguyend2 : martialnesses
sgoings : modicum
kojimam : grotesque
flanagano : representment
readyp : acidification
kirtnert : pinochle
musan : microscale
tanm3 : bloodmobiles
arroyoruizj : unthriftinesses
emckinse : epicondylitis
dfedorova : clutching
tisdalej : tonetically
princeg2 : concubinage
staffa : rivos
williamsc4 : straws
yangn2 : sleechy
games : descension
siddiquia : wens
wengs : wens
mikulskit : nextly
liuc4 : albricias
thomask2 : chimneys
jstrand : spenders
dln : bunding
bestb : embroil
tangumaj : nonsymmetrical
traylor : temporalizing
ederingtons : skateboarded
uribec : admiraunce
johnsonlacosss : rerailing
rohdem2 : lobbyers
moshfeghih : severalty
keiltyf : underemphasises
mustilloe : campsites
knezevicm : climatising
zhangj8 : honourableness
rogerss : taigs
schafferb : nazified
pennellb : spivveries
lellison : disceptations
spatters : brazieries
pilled : omening
akyianun : ejects
kimballk2 : unsolemn
renem : fiddlers
leeh : sorrowed
trawt : wirelessing
moralese : aygre
parkersone : questionlessly
deitzman : pervious
goldmanc : brolly
folkst : curtainless
lynchy : sighlike
caser : dependancy
leakek : facsimiles
jiab : serialization
mihiram : nemesia
kondratiukm : natural
mellinb : spotty
zhanga5 : overassessments
taradayl : scrobiculate
rfjones : phlebitis
chutkows : sidhas
mcwilliamsc : chalcopyrites
rosenbergm : vaticination
lid3 : sovietisms
www-data : satirized
eislunds : keelhale
kellyw3 : kindest
alvarezj : transparentness
manivelm : sketch
ashe : gynaecomast
fredlandt : fey
budde : yow
davanzoe : laminitises
langee : forereaching
araujol : shtetls
painem2 : underarm
fordr2 : stomatous
eegge : andantes
mccraryz : disks
antrimr : phosphori
boylee2 : codebtors
simoncat : manillas
kyhlm : rontes
jdavis : preexistence
busheej : tuckets
floresg : deposited
siuo : apocalyptisms
cunninghama : scranny
blairs3 : wisely
howardm2 : grandparenthood
johnsonk4 : landfalls
gordonz : sustinent
dellefaves : schiller
mvanderw : miscreeds
steineri : tribble
smohring : pioneered
rasmussenm : kilims
powerj : usualnesses
ortegaj : trochleas
wolft : lasagne
karnuaha : bridle
farwellg : helpdesks
drapert : unfeudalize
sobels : aggrandisers
moyerj2 : substitutes
harrisn4 : enjoinments
falka : seldshown
dennen : ampicillins
shresthaw : emprises
kalmusm : unstrips
euwinga : dedramatize
davisonm : derepressing
zhongj2 : bootlessnesses
votawh : powderer
maxwellc2 : redivision
busht2 : dibbles
isaacmans : gainfulnesses
mohamedi2 : boileries
jordanl2 : disinvestment
keanel : deadheaded
chenj3 : pulpwood
cokera : empoldering
vermam : parring
abdallan : numerousnesses
biny : mullahism
hawkesk : glycaemia
forsythm : pygals
lehra : chains
turnerb2 : subdebutantes
yushkoa : outvoice
rosenbergs : zincous
gullicksona : ticks
scapicchiod : peakedness
choom : chefs
wuz : brucellae
riquelmev : redisplay
malik : charmingest
millerr2 : tachometers
garbym : succoring
tut : empathising
huanga2 : dissemble
zhangc : overregulates
zouy : ponds
nika : pudding
sudderthm : notates
plevinj : aerialities
vcoleman : passment
fuhrmannf : twoccing
chathaa : replete
sbeckwit : mythically
cowane : keloid
ramazanih : geolinguistics
schafern : diamonding
geistk : marrier
parsonj : transmittivity
yorkd : says
selkowitzj : exceptional
dominguezj : demodulate
smithc6 : remated
raon : unprofessed
lamn : hemocoels
lowej2 : contraprop
overbyj : corpulent
paulsonl : unremarked
johnsonb6 : amylaceous
xiangx : slaphead
sampsonj2 : fetterlocks
williamsonw : bushelled
endoi : farewell
freemanc2 : mudpacks
farmerk2 : recommence
frym : gismologies
yuc3 : cevadillas
songy : gormands
parke2 : twanks
sinnerp : feen
josephn : terrines
hillz : khanjars
gregoryj : outrightly
djerfp : destabilizers
wangk3 : wows
arche : armrest
chene3 : provincewide
whoopsie : imperialised
pappaa : systemics
limz : broomstaff
fitcha2 : postcranial
ismails : palletisers
merchantj : idealization
nobody : outcropping
riersond : evaporometer
snidmanl : gladdon
pasleyo : lateralising
odiernog : vassalize
koeniga : vassalize
huffmanj : agrias
gnome-initial-setup : anticipatively
diazgarciaj : skails
jonesb2 : deionizing
santosb : dwindlements
zhub : wakeman
yangl4 : lense
acerom : rectum
shibuik : initialize
lina2 : sententially
wongc2 : derig
leslieg : dolmades
nevillek : accomptable
floydt : otoscopies
cabaacevedof : figure
kleinh2 : dicrotous
leikikhe : duodecillion
schlicke : coenaesthesia
ngot : unfeed
walkerb2 : noncorporate
ishikawas : formulators
yamadaj : antherozoid
marasht : antherozoid
willickd : nondrinker
leek2 : bunde
grovea : cowlstaffs
xiongk : multiband
osham : trucage
parrm : checkreins
valdiviam : cirripeds
flinnc : interkineses
marquisz : brief
nahleyc : passibility
lius3 : cropped
quadea : peccable
sirulnikb : puttock
engelk2 : bawneens
badjouendzouabea : ozonations
liuq : hemicranias
taylork2 : renewable
vonderlagej : backouts
relveton : ideogram
chappellg : staggiest
rowlandl2 : titlarks
pinac : benefacts
nakasakaa : localist
jensenm2 : paraenetic
garcial2 : hirsels
quitmeyert : lettuce
vuea : spredds
bowmanh : unsurer
cunninghame : enthraller
ellisb : tuckers
siffg : adorably
kchapman : haugh
songy2 : pulsation
kleinhansc : disponged
trejoc : cusso
causeyj : naughts
blagburnd : taperstick
dingc : teen
sweeneyk2 : geomant
wangc4 : weevers
tranh2 : outwishing
mones : reflets
chenr6 : dispraises
engela2 : railroadings
leblanct : compiled
pozzii : yuking
destah : preprogramming
shawj : overharvest
mere : syllabaria
reedc : tramontana
chent3 : prepones
evansg : pickproof
debenedettig : blinkard
hikinok : woodgrouses
rankinm : chizzes
alis : reopposing
drapers2 : luminances
ullmans : deuteranope
papajohna : smoothers
aloy : nonevidences
raiyanir : embosoming
wangs6 : regularly
wangs9 : cudgeries
ntp : sclerotioid
bubulaa : astrictive
ntomonar : filmmaking
leel2 : scanners
johnsonp4 : smeeches
furlongj : excorticated
chena5 : plasticisers
gorordoa : updaters
choiy2 : relaxedly
gravesm : endosporous
moriyamaa : coiffe
engermank : gummite
nykampd : womanizers
jeony : cenacle
borlaka : prospers
raka : disharmonizes
rizzoj : twinship
miyazaway : preshipped
younga3 : nadiral
johnsonm3 : inventorying
charlies : induration
milashusj : fizzing
yangw2 : overrunning
serranon : decayless
morelandb : asthma
gormallyc : situlae
vanderc : susurrant
kharea : stomata
muellern : whaizles
eidelhochm : antidune
lewisd3 : dephlegmator
goulda : foretokenings
seefeldta : aboulic
kunzmank : fervidest
systemd-timesync : thingumabobs
thronea : flashforwarding
seleym : obligational
pricharde : checkerboards
normana : hawkers
iftikharw : scarth
wahlj2 : liquable
satrans : lexicalisations
nicholsg2 : unseel
schnepfw : lompish
williamsj5 : jackeroos
dmarshall : paginate
finesr : rejoicements
nelsonb2 : criterium
saksenac : checkered
halladaya : hydrolysations
nguyenq3 : mopboards
dowlinge2 : chaced
fosterk2 : skalds
huynht : droner
dongz : loathed
mcclintockl : coseys
dubins : barbican
wongl2 : crinkly
quattruccii : lapidist
lewisz : urethan
brumbye : blockader
fstram : corroborative
choij : prefatory
luongn2 : stenched
solimanh : sedum
cwoida : approving
zunigao : denervations
tune2 : drearihead
smitho : deadlift
josowitzr : keelhauling
rileyi : gleeman
mensahj : mumbled
wangw3 : polysaccharide
luebkeo : boltholes
wrighta2 : battener
rosez : trematode
lobetg : emulating
bistrupi : multinational
bosmann : boltrope
glennb2 : flowerettes
tananbauma : unsurpassably
tokiokat : summiteers
mosborga : rubberise
cerdaa : lofts
kuritar : gatvol
rahadiana : neurilemma
glaubitzs : agons
ifedic : dogfaces
kischnera : bickers
guangc2 : desulphurizing
siyakurimam : resetting
maldonadoj : pleximetric
salijk : didynamy
marquetteg : phlebitides
zhangj11 : enlit
steverb : potentise
hoppera : prosodically
syslog : heftiness
yanj : heliostatic
naw : cobbier
parsonsa2 : bratticing
noisecatz : beneficential
jasmerj : epicanthic
stametsm : sewerlike
dalberg : synchrony
dappleya : flatliner
hoopera : convenors
keeleyh : balkanisations
delgadoa : triality
rwells : glucosamine
sledgek : adducted
sethl : reswallows
shieldsc : collaborator
liskot : deflated
samuelh : nicer
drummondj : nathemore
thurstond : concelebrating
rosenbergh : plunderages
meierj : transposon
qins : intrant
leonarda2 : emanation
katariay : yince
yazdanpanahp : shunamitism
puzellaw : damoisel
nortona2 : dovers
dstephans : spikelet
quigleyt : stiff
bakkej : stied
hanshawf : rajah
parnallm : hirable
morrisa5 : nuncupates
linb : oaf
robinsonl : epicalyces
pelegrinj : imposingly
grossmank : mice
kraabels : jeer
robertsa2 : buhund
hosem : servileness
kleberd : kibble
tae : doobs
floquetl : pasters
baggetts : refract
zhangj9 : meseemed
irc : tifted
morscheckc : monomyarian
intrateri : virulently
uttleyg : defervescences
lchihara : sensitometers
qil : ginzo
cheryb : frogeye
kressek : galactoses
smallj2 : untruthfulness
chasnovm : adyta
dregerm : beringed
lima2 : paedological
bjackson : thenardite
roesslera : clops
ghaneabassirik : convertible
nusaibahn : bailers
uucp : supersensual
melvillec : reverberant
davilav : coronagraph
bhogarajus : including
wanga5 : quicken
moorej2 : aboideaux
tun : prooemium
lesneskia : hyperpure
paulsenn : acceptingness
fostert2 : langbeinites
dass : ataxic
dbastola : grillade
krajcc : efflorescence
colord : plessor
jonesa2 : hutment
cablkm : incomposed
rybarczykj : choreographers
mohamedm2 : for
jonesc2 : abele
choud2 : launches
jcernaba : adjuvancy
lattaln : antidunes
bettnerb : peddler
bassp2 : salicin
trucksest : scordaturas
lsattler : knickknacks
jsnyder : yaqonas
mosesh : joculator
sys : nonequivalent
vostinar : jejuna
gronholzj : untouched
shufrozletzj : meltiths
masindel : hypsochrome
jbushey : orinasal
christiansene : irruptions
parkj4 : excursion
coyleh : tolerationist
pulse : deuterogamies
liur5 : orthopaedy
ngrawe : piping
hernandezo : yid
chamberlainb : bedlamisms
newmanl2 : pickapacks
zuczekx : bloodguilts
arafferty : vanguardist
chenga3 : bridegrooms
nguyent4 : cluster
hemmerk : aquafarming
savagel2 : banselas
walutesj : trochites
lynchm2 : hallmarks
reeshille : sulphathiazole
kroegers : haircloths
tordib : dreariest
shucka : driveller
mitchellm : satellitized
shanson : ungarnered
forstere : unanimously
ratzlafft : nonhospitalized
tbarkmei : inflatedness
nystromk : fellwalker
bregouc : dill
louisa : pharmacopoeic
hansonj3 : superexcellent
yamadad : adonized
moreesandersa : inhalant
halla2 : interplead
wangn5 : epigrapher
smithd3 : stoope
bernsteinr : soredium
yangy2 : kingpost
mateosk : secretions
docterloebj : recalesced
zhangs : gummies
jbryce : technospeaks
shaot : houghed
zhua4 : proofreading
morel : diageotropism
mazzolae : sheen
ealexander : pavers
alveys : ballanwrasse
rykhusm : stabber
gullicksonp : topaz
neumannl : caudled
oddene : corporealism
newellr : raggs
detmerh : raggs
anzalonem : myriapods
delgadoj : seminomadic
franklp : cravenness
sayanic : hospices
polancoa : quakily
marinoa : confidently
preissb : laryngophonies
adamst2 : locales
kellerm2 : bizarre
masakin : patronisers
jenksg : microcosmically
whiteg : foresaying
turnerk : alkaloids
flemingw2 : spotlessness
lorda : polyethylene
makatsariaa : dolorimetries
tourea : argyles
jdecker : comparative
vosena : soapboxed
baldoj : chemurgic
jweisber : interracially
petrinih : atheises
wiegmane : witney
boeror : tameless
hernandezc2 : exertion
lintone : outboard
hum3 : ultralight
dirkswagers : zebrinas
omoiyamuo : machination
sagalg : coachy
neimana : negligibilities
lottb : inharmonicities
pottero : benzins
paradac : breem
saintils : opercula
shuffeltonj : overvaluation
boettigerl : wold
hannak : flakier
luoj2 : adnations
fraziera : hairtail
jonest3 : pinochles
barryhan : denigrators
allenj2 : woodspite
hicker : tavs
soehnlinn : senarius
goldhaberz : mispaint
grimlundr : frichted
samselt : androecium
votrubam : disgarnished
frostb : saprobe
mukherjia : skerricks
storliee : upbrays
tuslerj : upbrays
snowbecke : extruded
deanj2 : chorals
wiggint : mameluco
moranl2 : crowder
gautamaj : duncedoms
alexandera : luskishnesses
yaxn : shatter
roeslerm : urceoli
fairk : acceptee
lunae : efferents
healyr : astrohatches
dierse : abdabs
mallika : saltation
lecuyerj : interclusions
xues : debugs
ybenami : aceldamas
vaughnj : leetle
friesenh : demutualise
kimzeyo : airfoils
garayj : homeostatic
dmusicant : comprehensively
haigha : tenacious
loewa : dongle
maags : elocutes
wangj6 : bluishnesses
iyera : overlaboring
klee : torulosis
monahans : folklorist
goodmans2 : demobilising
mcgeheej : circularity
kaushikkarn : wastrels
twinings : roadshow
heilbronnerr : bejesuit
shenm3 : challenge
mcadamsg : lectin
georgep : unmaking
deanp2 : ropinesses
hirshmane : scaldberry
jungd : houris
oguhc : peptising
barnhartn : deliming
sajwanis : whipsaw
marksb2 : undebarred
root : spitcher
lees3 : quamash
jansenc : solas
guzmanc : polynomialism
gilbertk : monaxial
horwitzb : monaxial
czimmerm : fineableness
petropoulosa : interconvert
ziemsr : mundungos
rweiner : dumfoundered
grandem : psellismus
whitet2 : tactics
fischere2 : laterisation
dirksr : zooning
schultzm : scabbling
guv : electrisations
mullanj2 : foreking
williamsl2 : docibleness
andersoni2 : directorially
olsendufoure : chattinesses
tranb : heronry
rockd : radiostrontiums
abebayehub : ingresses
abougabals : hippophiles
casperd2 : eidetically
diazg : rightly
zhengs2 : bergfalls
ballen : sledging
capeilleresh : soursops
baigt : knightheads
sullivanr : multinucleated
asifs : peysed
tianz : centums
cordovai : zoogeographers
balvuenaa : twisty
satisha : sous
cooneym2 : inside
joness5 : pressing
washingtono : ambushes
tassavaj : bushrangers
mayerm2 : scrotal
jonese3 : spurnings
venturaj : northernmost
dickeyc : provincialised
mjflynn : embothrium
cherkashinaa : lyophiled
jaffars : santir
preisserh : condensation
appelbaumj : thorny
vancea : elemis
guilloryt : suggested
gershmanw : lickspittle
konidenap : iratest
sottrelh : rewaken
sassl : collegialisms
luc2 : minimisms
sunk : errhines
crewsa2 : spectatress
northovert : brachyodont
chungd : matched
blaneym : pulselessness
lankfordr : replaying
khana2 : orthophosphoric
gwina : amitotically
robertsr2 : belugas
humese : mucate
radinskyj : toparchy
huhe : pianistes
offmane : episematic
stoutlandi : ambassadorship
hopek : sumphs
contrerasb : foreverness
velascom : offside
rewc : pronators
buik : forgettable
furtadob : alkalised
goodmand : hyperspace
baeckn : inukshuk
veeambackup : drapes
judget : mistressly
rapaczs : massicot
beckerr3 : doctorial
aswoboda : kyllosis
soforenkov : leishmanioses
hughest2 : slimiest
charltoni : stepladder
gotchs : irideal
millera3 : hydrilla
pstowe : soleplates
daib : derivatizes
hughesa2 : bushtit
thayain : ululations
stephensm : nickel
gueyec : elflands
loehrm : unchaining
arnoldp : commandantship
roskopfe : polka
wangk2 : gynecologies
maruyamak : gulpingly
bansea : salpiform
shemwellc : bombastically
collinss2 : genius
assalip : warwolves
pinaa : encrypting
kortaneke : prescinds
smithr2 : skydive
johnsone2 : preclusively
kennedyl : sunward
luy : teaze
smiths2 : sarcastic
fordn : messaging
leonettia : yeasayer
haywarde2 : conciliatory
ihlenfes : cubicalnesses
velasquezc : mapmakings
hussains : helleris
mccaffreyl : bibliologies
mendiolam : adsukis
hansonn2 : elders
kirkhoper : secularise
leonegettens : tankbustings
digavallik : deoxygenizing
maringc : impresa
mendozav : adiaphora
paltrowe : beadswomen
adamsc3 : veriest
passinok : addled
wange3 : smirked
bovassob : pursues
keena : potgun
zerrs : clumper
schwabd : fingerpost
hawadlea : fadometer
meesenat : lemurs
cohena2 : safety
brattonb : catechisings
schattenmannl : levellings
tarteri : tetratheism
pbernhardt : legitimations
persella : weans
hamida : guarish
zhenga3 : hideaway
wyckoffs : fiasco
toledod : hoidenishnesses
mail : abasers
neidharte : anatropies
thaon3 : basics
edmondsh : semanticists
drakel2 : mossier
hurtubisel : dysmenorrheal
yumk : seat
zhuy : noninfluence
lin : supersystem
panm : topograph
gustafsone : comfortingly
kluse : piing
shrinere2 : nonaction
corboo : biogeographies
foxarnoldd : hypermarkets
amoltcha : yrent
quasts : seckel
jimenezc : shiso
jenseng : platform
melomejiac : tissues
deleonc : regalements
minoe : jiveass
stolberga : cob
sinhaa2 : misapplying
nawm : canephor
lib2 : paleologies
olsenf : agroforesters
laveys : phytogeographer
hembrei : rosarian
wormanm : glottises
lians : adulterine
blacko : canephors
kammannm : enduringnesses
jimenezf : merman
ferrerl : cariole
shaoe : chalcedonies
wonnellr : citizenise
harmonb : caesareans
helmboldk : demander
kallinn : unlawed
timminse : kinematographer
jamy : ultravacuums
khesinm : billed
zerwasb : backwoods
macleodh : axially
usbmux : stactes
chill : sluffed
varmaa : regrooving
hollowaya2 : catchweight
lina : mensurabilities
msehgal : neoteinias
lees7 : prorogating
klaym : tofts
uchitelj : belowdecks
diallod : prehension
shapirol : disgustednesses
steinl : evaporator
mccartys : versed
macdonaldj : amauroses
coyleh2 : speargun
sshrestha : unessayed
suwalk : foreshewed
jinleeh : bloodiest
mohanm : nonresistant
espinozad : elongations
barbere : ecossaise
chengn : rearranging
carragherj : splurgiest
delgados : coliforms
scottm3 : psammophiles
liq2 : cloots
shallenbergers : semifit
yanga2 : joylessnesses
mcgregorr : canescences
conev : midwifes
stroebell : unfilde
yimf : edictal
munn : floppy
daemon : statua
marquezd : loanword
heartz : unharnesses
wangm5 : sufficient
thompsons : trichinised
saxerg : queazier
margolisj : reseeing
hoenem : charangas
lakeh : gadwalls
dushimea : copples
kotlera : tenantries
myerss2 : shrivings
tnega : coeducations
smithm5 : unstripping
lattala : insalivating
milliganc : entwined
fridkina : reduce
bin : liquating
lefebvres : abseiling
cullinaned : plainspoken
willist : vaurien
porterm : organities
flaksbergc : preoral
laubo : fatbacks
shiy : planner
osmanm : bergomasks
czernieckiv : peripeties
ktomlinson : lactoprotein
tullioo : bairn
kotulae : sulphureous
jurotichm : overreacting
eliasj : proscriptive
rughanik : pasquilers
mandalas : syruping
sync : nonevents
wnorth : supplier
swarups : tootsy
hmiller : overorchestrate
choie2 : parleyed
zhangh : sodomies
gudav : queenies
nowakk : prolated
yuane : tailboards
rosea : quelched
polonskys : nimbus
munkr : yersinias
yangm4 : nanoseconds
lazob : unpunished
mccartneyr : hyphenated
russellb2 : platitudinizes
donnellym : expensivenesses
luoy2 : halieutics
callahanc : smartly
pintos2 : czarinas
lengyels : stockbreeders
ismaily : unprisable
masoe : overfocused
brownp2 : tollgates
quinnr2 : faineancies
liuf : isabella
amers : alternat
lynessi : snidely
luongh : perambulators
pattersont : sprintings
zhangs4 : shabbier
boydl3 : confrontations
ajohnson2 : currachs
lewism2 : botanomancies
chekhovoiv : arteriographic
mooren2 : wildering
gnelson : lieu
frohlichh : throwing
hallmany : travestied
lentzo : logographer
fredericksa : toroidal
peoplese : nurdle
nguyenq2 : spellicans
goldenbergz : expecter
caryswansona : desaturation
gerardc2 : anticommunists
sebertf : swapping
newmarks2 : rockaby
etelsonl : scalpins
mtie : monologuists
ostromk : downlights
lightdm : osmious
donahuel : patercoves
falkj2 : kalpacs
nancea : drench
chenk4 : reaching
lus2 : convenes
palmbacha : railleries
mccrearyw : fashioner
neithartb : rappen
garciaj3 : champak
arzayusl : numerical
schultzc2 : beeyard
rapaczs2 : pterosaurian
jettya : broodmares
christopho : spirem
typrins : kerving
buddie : disseated
hikens : loke
robinsonj2 : confabular
slopez : tuckerbag
johnsond3 : sutleries
pinsonk : paramastoids
levineb : warpaths
misraa : gauss
mazorb : dribbers
whartonl : attired
garciar2 : duraluminiums
chent4 : youthening
munyeshyakam : berberises
eldridgec : auctioneer
miyagik : resistless
diiuliol : entrancing
enzg : newsgirls
mrood : disposings
singletonj : incuriously
mmontee : lew
greenleea : epistolists
wienerc : novocaine
duncantest : unpanel
goldbergm : undertoned
fabera : aspis
barryj2 : firths
vazquezm : bisexually
rivkinj : forbare
apoppick : bipartisan
connj : savoys
batesh : savoys
villarrealv : gaboon
tcpdump : reefier
isaacsj3 : flautist
kniserm : cofeaturing
thomasa2 : portulan
topels : diluteness
bartelsj : orthochromatic
klosa : manifestable
liebermane : parsimonious
caoy2 : yellowbarks
onabolub : siderate
neidc : thievishnesses
leveyswaine : feelingnesses
morduchl : ratoon
murphya2 : easting
shenr2 : reflexed
wangy4 : stencilling
appelj : bunkered
dakaw : leprosies
agarver : glutethimide
schwartza : bedels
haugk2 : agapanthuses
kleina4 : disavowals
shahidm : stanchness
lessers : settlements
sieberto : undiscovered
hev : ustilagineous
mayoralg : kingmakers
postgres : visiophones
kstclair : descriving
ohrstroma : archival
korobovaj : uppiling
ristinoa : multidivisional
redmonds2 : moldboards
wangm2 : editions
mazura : chloroform
mccoyc2 : genialities
grayzelc : palpebra
mcferrink : outserving
johnsone3 : ruggedization
bartelj : byrnie
nelsons2 : supercarrier
hagueg2 : fairies
madsena : perilousnesses
anyaegbunamu : macrodactylous
cuid : telegonic
shahs2 : administrants
hashimotok : outdazzle
smeerts : secularistic
klangsathornp : coyishly
leeb4 : unclipt
trant2 : glacially
rojeke : damner
neyc : ampassy
shabaitah : callboard
fjaramil : misentreated
moralesm2 : zooperist
kachmand : assarted
icklerj : lockmen
rnau : gleefulnesses
zackss : hallway
skennedy : remoralize
pfeldman : way
rawlesa : enregimenting
blackmonjimenezd : blipped
rajbhandarya : libation
cjohnson3 : setoff
gruhlkea : nonkosher
bakerk3 : subcivilized
davisb : prent
ruasanchezf : nouls
jewelerb : basilica
jcwillis : animalise
mandavar : flowerful
orensteint : heliolatries
vinyarda : hiccoughs
dannal : deixes
sirothphiphats : grumphed
ramirezt : braincase
chatardl : suggestionist
truebenbachc : reinsure
avahi : denture
washburna : alcidine
rodriguezd : mispaged
schaferb : sharesman
kangt : gobbledegook
khayatn : mingimingi
stecklowm : glitzed
cohena3 : diemaker
seidmang : teleferique
grayt2 : ligure
subramaniana2 : hawker
nicolas : vulning
vandele : radiometry
leppinkc : dialoging
bauern : halternecks
thulsont : muumuus
heuchertk : golpes
ringrosec : multilobe
moralesc2 : refulgences
sjaastadk : troublemakers
obiesel : yuletides
grieselb : puffbirds
stritzelm : lobbyings
sanghia : hitcher
chownt : vesica
stacke : satiety
lachmanm : squeegees
boileaus : tergiversation
wuy3 : ternal
rubinpopea : lirked
kuriyamae : underplanted
mcphersonn : apotheosizing
contrerasa : inefficacy
cfarhart : frenzy
neiroukhm : nutbrown
reedwestonm : systemiser
byunj : endocrinologic
rubeyp : glees
thompsond : foredates
mckinleys : sowne
rtkit : paddler
wangs10 : aerophytes
khana3 : manlikely
magerl : toxemia
dennisd2 : disinterest
parkj3 : hutzpahs
lautenbachw : waterleaf
waltersa2 : relegable
plackie : touze
trann : cep
henrye2 : dulcetnesses
vaganovv : ceboid
davisa2 : varityped
rahmans : effusively
reinholde : repressers
pengg : polyculture
benjegerdess : deuterogamy
priestm2 : cypresses
teferar : maculature
ogutum : outcompete
sugalskil : onstead
matthesg : grisgris
craigj2 : philosophized
rosenfeldk : scarabaeoids
chertoffa : overhasty
clinecolee : aniseeds
hahnj2 : antipope
intasinp : alogias
silvaj2 : thetched
dalea2 : marshwort
beasleyt2 : axe
millerd2 : bindings
dimondc : sabot
hansone2 : nightclasses
lantyderun : puddlier
clarkb3 : necessitarian
shaha2 : ecstasize
dongh : gangway
mcdermottm : fell
phamd : features
villagomeze : bokes
youngbloodl : backdates
youngrenk : pluralization
zivsaka : chemics
taskintunak : scentlessness
boslera : sunburning
drakedunnc : counterraid
zhoutan : bedel
yoony : regilt
khouwa : earballs
bergo : walkways
ksmith : spiciest
dubinskye : bokmakieries
bailona : cottier
ochoaj : tracasseries
donnellyp : sight
pseneviratne : restacks
tartagliaa : gunnership
ezemosakwea : chammied
kirklandk : crotchet
jacobso : enderons
liuy3 : sledgehammer
rankini : recessional
delgados2 : afeard
santamariar : somnambulates
troopw : asplanchnic
clellandk : virago
zemanj : chattily
stucker : abbess
willmorej : muttonheaded
zhange : idiotype
littleg2 : experienceless
rmitra : ologoans
thengl : pectisable
reegm : everyplace
youngj3 : emanator
goodea : eristical
moranh : replevined
polydorouc : pitchpines
zhangs3 : sapele
madsenr : incited
olsone2 : anisotropies
mccarthys : earthmoving
fengw : interrelates
laytonm2 : magnetograph
durdags : popularizations
monganea : solder
szetob : breeched
widmana : gelandesprung
karpe : grilling
westj : handset
jonesj2 : logistics
buchalh : unprovisioned
leed3 : batholitic
hussaink : enteroceles
choir : parochialising
laz : avyzes
zhangc4 : manufacturer
andersonr : magistery
fraleyj : corrodant
heynesk : hoodie
koellingh : shaggy
aldaghlasn : auberge
galambosa : outhits
ramekeri : proselytisers
quintanar : lukewarmish
vilmsj : tinplating
jyang : flittering
nicholsonj : fieldsmen
glosss : nectaries
walkerm3 : opaquenesses
gichimuc : boatfuls
nabaris : pinealectomizes
kuhsm : woks
sasserd : outscooped
moroccoe : acclimatisation
liz2 : ethnography
lwinh : bespout
gordonm2 : friar
alvareza2 : disembroiled
yklein : supercars
christoffersonp : discordances
laffayet : multistrikes
lemastere : plantling
tanakas : despoilers
hempels : recrystallise
shayam : hypabyssal
kwakb : extramundane
sutcliffea2 : archaeal
montess : voluntarism
prohofskyd : snatching
fitchs : pacifier
sonr : consistorial
osbornt : shiplaps
elfishawyl : ewks
ramosa2 : spifs
luk2 : trapezohedra
santamarias : legislatress
pengd : harmed
subramanianr : yelmed
kitamuraa : estrual
wernerg : postpubescent
parkern2 : misremembered
gunadim : matronship
bettmanl : doffing
lonea : hanger
perryb : pepful
sheny2 : hingers
ramirezc2 : treaclinesses
zhangd3 : compounded
songd : crosstrees
oishik : agronomists
richardsc : secureness
aronsonj2 : comatose
gardnerc2 : crozier
heine : gam
baxn : squib
ehrhardta : pentastyle
yaps : spongeous
ralaimo : wiretappers
hansonc2 : trollius
fellandm : rachillas
jryan : teentsier
hundeh : depredatory
loea : outseeing
freedmane : scapes
flignorj : irreal
mkaga : connivance
moonblackj : defensatives
watowichm : pensionless
cuil : morrhuas
mbailey : posticous
meia2 : joky
phelpsr2 : turbid
dunnr : disagrees
guana : rheumatologies
pandelakisn : incompatibly
jamisona : frivollers
herreraf : employability
omosunj : correa
jscannell : dentately
winhallk : definition
csedrikv : schizziest
petersl3 : sluggabed
leisherz : cordialnesses
delgadoi : peptonised
thurowm : gearings
johnsonp5 : quoteworthy
rosenberga : tumor
pearsong2 : forelay
gaoe : decagram
conlang : underplays
naikolsonr : awhato
leec3 : reenergising
obora : materiels
tetie : unfilmed
wojtowiczi : guilelessnesses
leffela : tracks
fergusonj : sided
sangvongp : gratitude
preet : colic
nybladel : allod
christensene : gringa
hadjiyanise : outpitch
wcisloa : cornuses
wellera : undervest
vithoontienl : restier
nelsong2 : fimbles
chud : chlorinises
jamesona : grooms
schafers : neophytic
trana2 : xylomas
hhuergo : schmaltzy
hodges2 : chunkiness
eleveldb : firmwares
dorchens : bhistis
kollr : buzzes
prichards : interfiber
nykampc : overleather
vadnaiss : resods
tmadsen : empathize
walkerg3 : harn
krollc : creping
priemb : tamandua
kiml : decoupages
huo : commers
youngk2 : nepeta
mungerk : chomping
negasis : sashays
ortizfloresr : appropriator
tranr : flaccidnesses
johnsonj5 : mooved
matha : blockishly
johnsonz2 : yampies
smithc4 : hirselling
klineb2 : overdeck
bhowald : kenotrons
cochrane : dragonfly
guox : punctation
xiaol : napes
hallc3 : viscometry
cburden : jarrings
paezt : poults
worrellm : subprioresses
cummingsg : retrodiction
pelletierz : palletizes
hooperk : yes
ellisa3 : nonglare
bettnerj : professorships
wilsona5 : coulometry
ramirezl : dyothelites
jingg : reconquering
roslanskyc : inculpability
schuelkek : wellsprings
tpittman : sanies
huangv2 : motherhood
friedmanh2 : oinomels
rittera : bastiles
berganrossp : ulnas
duanc : polyglott
commonsj : includedness
pedersena : citational
saida : timebomb
maitlandl : spinner
garciaa : demythologise
kange : scruplers
foreros : soterial
barkerk : tutelars
yuana2 : educts
jalilia : dragonise
fwupd-refresh : galyacs
averyt : megaplexes
songc2 : forebrains
mccreal : floscular
claussa : antiphoners
ssippy : pornomags
lanierd : interment
dhugumak : mulley
davide : patisseries
aestill : goatier
georgeb : halidomes
dawsonr2 : reacquired
northj : palpitant
phinneya : landmarks
zhangm3 : intelligencer
loesper : lowan
barerj : axled
boskovica : turtle
donahuea2 : symbolling
lichto : eyepoppers
meekerd : toroth
flanaganr : expatriatism
tuttt : susceptive
groosj : fluxed
dhaunspe : mucocutaneous
johnsonl3 : eloge
stockwella : retentionists
trank3 : everblooming
wattsa2 : piggishnesses
harrisl2 : millerites
yipk : underwing
cruzsanchezk : baldrick
uyedah : pseudoscientist
dillmann : magnifies
knappc : stonewall
heinzelj : coacervating
kampa : paroccipital
clevelandj : stenchy
morrism3 : vire
tehranin : magdalens
francos : resistingly
ericksonw : musicality
odak : toughenings
greggr2 : tufts
haileabd : birken
perfettos : squinancies
shim : stupration
changstuckiw : maneuverers
lauere : unfriendliest
mitalskim : collegialism
wolfflandauh : anankes
systemd-resolve : vena
gleasonw : haro
mohameda : repolarising
lionf : playgroups
kuh : cellentanis
moralesk : schillerised
jonesz2 : biniou
icklera : mortarless
lasterk : chinaroot
streiffn : tranquillizes
mam : dogfight
ingrame : cochairpersons
ckelling : rebato
stojanovicm : millrun
ismaile : initiatives
masaddee : fractionary
raiu : devitalized
reidn2 : nonsmokers
patinon : missionarize
zhangt : tracheitis
dacunham : locusting
lekkis : laminating
reisenfelda : isentropically
odoome : troak
sherrickb : begrudge
katarie : glycemia
fletcherw : predations
steinl2 : rozits
floress : bromin
liny2 : prechilling
wittej : aberrant
vegas : monophthongize
greenm3 : protoderm
langreen : overgall
yangz2 : enfleshed
sparkss : perceptibility
collinsm2 : factors
clipperd : bandaged
kessenichs : protophyte
raicevica : breastfed
reidn : lavalliere
mkanazaw : existents
kisickic : splotchy
zhangl : redrafts
cochranl : shogglier
friedmanl2 : lahs
orjalae : spermatoblast
adalal : ests
awb : craniological
farrelle : thermographies
spaine2 : doghouses
foxr2 : outcrops
honga2 : immunoassayist
andersonh2 : nonnative
sshd : skoals
weil : potsies
taniguchim : inflammatory
tranc2 : tragopans
wuj5 : catalos
kellyp2 : pyrostats
shusterl : contractions
stierh : nonillionth
yuana : battological
harrisona : kitteny
ramazania : radiational
onyeanuj : pimpmobile
wangw4 : treelawn
emmonss : contributed
kims3 : fetichise
ogilviej : immewed
paulsoni2 : brushwood
simanekc : drag
beemanweberm : chough
steinera2 : unrolled
mlepinski : cabstand
ahmedt : podzolizes
marshn2 : nostoi
tennentr : pantisocratical
thantm : blebbing
luljakj : asepticized
strikem : instalments
williamsa2 : skreeghing
williamsc3 : malices
edstroms2 : sosses
kernerm : verger
caseyg : overlards
polleym : jetties
apattana : chout
honga : edifyingly
zhaidar : monadically
lyonsg : urubu
kadams : merrythoughts
estradad2 : cartomancies
demetriadest : forefended
muenzere : trolliuses
merchantc : tensibly
macveaghc : meads
odubayoj : battened
tamert : biotoxins
zengt : unboiled
watsonl : polyimide
fariasa : refuged
millikene : steelworks
raderd : librairie
dennisd3 : gastronomical
seths : smokepots
mehtaa : insouciantly
taftw : antetypes
colindrezn : decollate
mensendiekh : assibilating
rechtini : entrammel
cyandell : terrorising
wangh3 : airpark
kutchere : heteromorphisms
ketemah : gabbarts
gmarflee : vastnesses
batsaikhanb : urticating
teggatza : insularly
mantillam : jambiyah
kuangj : merchandised
wilcoxt : parra
garciam3 : rewarewa
abdulf : ichnographic
arnoldm3 : retraces
knudsonm2 : immeshing
majumdarm : hordock
jussilak : nomarch
varelaa : disacknowledges
diiannic : shoutier
brachoa : inturn
romanenkos : literalization
johnsona6 : rattish
jhoelzel : arshines
leona2 : truculently
tklinge : portoises
teichmana : conciliator
donovanm : locationally
chardy : despiritualizes
abarrios : whitrets
frankela : formal
moreb : brinish
lia3 : fatiguable
voting : corrie
nguyenj3 : touchbacks
xiongx2 : testerns
burkhardth : evict
nairs : medicamentary
bombeik : gutturals
hamlino : immortal
norwoodl : amazement
rheeb : couche
hallk2 : cathouse
lewisr2 : undecillion
starlackr : minister
riessb : directories
rajad : wedgies
pinkneyn : cloddishness
websterc : bakras
claphamc : nonsequential
bozicevicht : hyperborean
shapiros2 : fifing
navarrob : nonloving
gibbensa : apospories
garciab2 : smirching
hanleyb : macrocytes
rosenn : unaired
ejensen : coalyards
nlutsky : inselberge
yangb : steddy
zeidenbergn : scrowdge
jiangz : elemental
hiltym : collaterality
patels4 : stainlessnesses
hoj3 : pouter
carlsone3 : acidest
armstrongk : oreographical
guangc : sandshoes
newmant2 : tachylitic
tiennotm : propylene
bengtsone : respecified
pompern : diastema
isbelln : echinodermatous
jhessel : roti
sfox2 : cysteamines
emlent : simonize
kgalotti : fayest
dflynn : semeion
lowryb : dissatisfies
viegaseguiaa : bohemianism
davidm2 : suffragan
wrigleye : ratiocinatory
rubinot : archaeobotanies
hassellw : cacodaemons
tranm2 : resculpted
schondorfa : quashing
zhanga2 : terremotive
xiaoa : associationist
liuh : gites
ansara : lungwort
hudsons2 : welwitschia
sivulat : dimerisms
sakamotoa2 : implex
navarroj : bluidier
watte : atrip
starkb : reexpel
hoytniemieci : obfuscating
gilberts2 : obliviscence
imaik : gutser
nullg : commodification
mitchelle : rotolos
joel : motocrosses
boulism : novelty
lesurea2 : entoiled
peterz : undereats
hawsj : anticize
drivere : spunks
maxwelli : gumbotil
brennano : waterproof
greenj2 : axiomatic
ericksonl : bootikin
dauriac : anlages
hafnerb : rerack
jamesh2 : stroamed
potterm : muir
cantrelll : butadienes
johnsona5 : counterresponse
dambergottm : hoiks
hannas : minimalisms
gjertsonm : overapplication
nwikeb : southered
zewdum : sanddabs
hansonj2 : expositorily
careym2 : daminozides
yperez : gallowses
mrand : aeromancy
lazog : respectfulness
muraharin : respectfulness
straubn : jinking
scoolerh : pyromaniac
rubind : focalising
avilal : reprogramed
yazdim : refeeds
shoveb : mountained
carteri2 : singlet
zhangc3 : dissonancies
julies : shoofly
tilsonk : cutlery
petersl : superalloys
brannanq : murmurs
rivesb : exalbuminous
lefkowiczg : ghee
alstonj : rousting
bagerekap : catworks
stepanskiw : pruinose
wuk2 : lustration
danksm : hiddenite
birgenj : shopwindow
rjackson : dragoman
palenovad : pinchcock
muhozal : mistigris
goenkam : recitations
rosenfieldn : pretext
omarac : disinflation
rasts : outpitches
schifferc : cheekiest
roethlera : nocturias
zhenga4 : fluids
reinhardtc : deckings
salazarv : rudderheads
laffertyn : uncomatable
eshetua : frikkadel
riverar2 : barbel
rojanasoonthont : trainful
cturnageb : homonymities
breyerr : guyot
vargol : gutturalisation
schustero : reshaper
onomiyan : slutches
lefeversb : subspecialise
chuens : papilliferous
list : oshacs
kozakim : musics
daviso : output
azanr : bemuses
izabayop : disputers
wolfet : jumboizes
bradnerv : nimblenesses
linderd2 : donna
mccarronl : cotypes
gvrtis : throbbingly
kims2 : hollaing
kartheisere : unexcelled
winj : pikeman
srivichainunn : amido
lobsenza : goober
bacigalupol : stratocumulus
ehresmannp : manteltree
change : insectile
demelolemosb : nobbily
keaneg : grogram
yanaij : fascistic
irwinp : zambuks
marshs2 : apayd
audettea : peperoni
jbrioso : wider
dinardoz : squatnesses
obergj : oraria
klinknert : steadied
vanormani : chechaquos
lees6 : tambourers
libergef : fastbacks
bergerg : begot
kimj5 : rotovated
spezian : rubdowns
lenniea : glossal
maneenoij : liquored
tarasd : metonymies
leb : beweltered
qureshik : chigre
birkk : dorbeetle
dpearsal : treillage
davidsons : primo
kiskers : megadynes
stametsf : surmounters
hiranok : proximately
murphyh2 : lapsable
fisherm2 : swarming
sschoenb : expostulations
sivulaa : boets
bonneviea : zigged
sallingerp : rosinous
atochab : envaulted
stewarte4 : tiltmeters
schurs : spugs
sanid : masculinising
jaya : plumbosolvent
buonopanee : gianthoods
matondor : glossist
targb : glossist
sagbaicelal : tertia
bergenee : beachball
nguyens3 : mylonitic
michiia : creel
daot2 : broncho
sachsa : yonic
thomasd2 : mechanician
weismannh : togue
wataokac : quoin
tlittle : tomograph
schaeferj : naifness
serotam : winders
idrogox : pyrolise
mistryn : orogeny
wrighte3 : equilibrating
finan : sibilators
tinea : crystallitic
zhaob : overeyed
blacka2 : insulted
mayfieldc : outpowers
blanchardm : disreputation
dewyngaerts : locate
burnsider : overcredulity
dawsonn : avantist
westone : deferrers
thomasb2 : unwashen
bonnellz : elutriator
feldbergm : antifogging
suhd : cockscomb
zhua3 : proctalgia
gullicksone : allostery
yankwittr : liny
chaul : meningococci
dengs2 : hugeous
smithc5 : retrojecting
smiths3 : rhonchus
hoanga : entranceway
iyengunmwenae : showjumpings
qux : pieties
muschlerl : mesnalties
bergera : bohrium
nicholasp : shlumping
squiresh : noahs
lentferl : megadeath
durnbaughe : whoopsies
crawmerj : shaggily
cooka2 : nickelodeons
