bjackson : boursinscrutching
muellern : shackedcornstones
kirkhoper : demonsxenomanias
leegilligana : twiglooslanders
ckelling : conglobatevalonia
huffg : distortinterventionism
alvareza2 : cisternsemigrational
yaps : premedsnab
kandelj2 : sunprooftoolbars
lozoyaa : spadergauntly
rfjones : benjesambrotype
averyt : migschlamydate
truebenbachc : lavabolitholatries
demetriadest : scuddingmantas
williamsn2 : scaphoidblondest
karnuaha : jeeliepillowcases
sewellk : ruttilytungsten
djerfp : backsheeshingsuperrealisms
fisherm2 : logopedicionophore
jdecker : cretaceousesrapidnesse
sutcliffea2 : epiloguestarvations
kindallv : constructureselenocentric
fjaramil : dipeptidedandified
sagbaicelal : decorticategunyah
corcoranj : scenarizedsmilingness
zhanga3 : megassesverbification
garbym : forwastespucked
sagalg : turndunsconfining
tyreek : hornilyclarioned
sweeneyk2 : haploidtoothy
shallenbergers : susurrusesiceblinks
dbastola : therologiesconcernment
qureshik : concretivedemonised
clellandk : obstructedpreexistent
pintos2 : yellowedbovinities
ksmith : eurodollarsdobber
escutiam : forlornzoanthropy
chenk4 : compelunlevels
gullicksonp : excorticatedwageworkers
madsena : prolapsusesfreedwomen
mahabira : anomalisticallyfrontless
mcgregorr : subnucleusessaltings
quadea : redealttester
emckinse : controvertiblyexpertising
zhangd3 : admissibilitypartitioner
hum3 : conjuresbecrimes
kernoops : joistedundescried
khana3 : crowsteprequickening
schillj : tuberculatecircuitous
knutsonl2 : oversimplifyfoulbroods
lellison : sporophylsheliotactic
shibuik : flounderedincorruptness
vonga : quangosbiocenotic
sanid : adverbiallycredenza
schultzm : abstentiontints
zhangc : fragmentisedblightings
steineri : displayertuilzied
boylee2 : beneficiationsbane
smiths2 : algatebookworm
marquisz : respacingcumbrousnesses
chamberlainb : tritiatinggurlet
choir2 : hotheadednessreaffirming
scoolerh : rationalnessmutineers
seidmang : cephalometricclostridiums
clawsoni : millimicronsscissorers
agarver : imprecisenessespatsies
engela2 : feesesergometries
lburdell : bluestoneplummet
walutesj : romanicitesicebox
dfoxgrov : respirometerwoodchop